1 13 31
###############################
#                             #
#                             #
#                             #
#                             #
#               p             #
#                             #
#         b   f    s          #
#                             #
#                             #
#                             #
#                             #
###############################