1 13 31
###############################
#  p     *                    #
#                             #
#           #                 #
#        x                    #
#                             #
#                             #
#         b   f    s          #
#                             #
#                             #
#                             #
#                             #
###############################